1 1 1 1 1 1 1 1
1 0 0 0 0 0 0 1
1 0 0 0 0 0 0 1
1 0 d 0 0 X 0 1
1 0 0 0 0 0 0 1
1 1 1 1 1 1 5 1
1 0 0 0 0 0 0 1
1 k 0 0 1 1 1 1
1 1 1 1 1 1 1 1
