5 5 5 5 5 5 5 5 5 5 5
5 0 0 0 0 0 0 0 0 0 5
5 0 0 0 0 0 0 0 0 0 5
5 0 0 0 0 0 0 0 0 0 5
5 0 0 0 0 0 0 0 0 0 5
5 0 0 0 0 0 0 0 0 0 5
5 0 0 0 0 0 0 0 0 0 5
5 0 0 0 0 0 0 0 0 0 5
5 0 0 0 0 0 0 0 0 0 5
5 0 0 0 0 0 0 0 0 0 5
5 5 5 5 5 7 5 5 5 5 5
5 0 0 0 0 0 0 0 0 0 5
5 0 0 0 0 0 0 0 0 0 5
5 0 0 0 0 0 0 0 0 0 5
5 0 0 0 0 0 0 0 0 0 5
5 0 0 0 0 0 0 0 0 0 5
5 0 0 0 0 0 0 0 0 0 5
5 0 0 0 0 0 0 0 0 0 5
5 0 0 0 0 0 0 0 9 0 5
5 0 0 0 0 0 0 0 0 0 5
5 5 5 5 5 5 5 5 5 5 5
