1 1 1 1 1 1 1 1 4 4 4 4 4 4 4 4 4 1 1 1 1 1 1 1 1
1 1 1 1 1 1 1 1 4 0 F 0 0 0 0 0 4 1 u u u u u u 1
1 1 1 1 1 1 1 1 4 E g 0 H 0 0 E 4 1 h g 0 0 g h 1
1 1 1 1 1 1 1 1 4 0 0 0 0 0 0 0 4 1 0 0 g g 0 0 1
1 1 1 1 1 1 1 1 4 0 h r q e n 0 4 1 0 g g g g 0 1
1 1 1 1 1 1 1 1 4 0 0 0 0 0 0 0 4 1 0 g g g g 0 1
1 1 1 1 1 1 1 1 4 0 0 0 0 0 0 0 4 1 0 0 g g 0 0 1
1 1 1 1 1 1 1 1 4 0 0 0 0 0 0 0 4 1 0 g 0 0 0 0 1
1 1 1 1 1 1 1 1 4 4 4 4 0 4 4 4 4 1 E 0 0 0 0 E 1
1 1 1 1 1 1 1 1 1 1 1 1 6 1 1 1 1 1 1 1 1 1 7 1 1
1 0 0 0 1 0 0 0 1 x u 0 0 0 u x 1 0 0 0 0 1 0 u 1
1 0 1 0 0 0 u e 1 u g 0 0 0 0 u 1 1 0 1 0 0 0 1 1
1 0 1 1 1 1 1 1 1 0 0 0 0 0 0 0 1 0 0 1 0 1 0 0 1
1 0 a 0 0 a 0 0 8 0 0 0 0 0 0 0 8 0 1 1 0 0 1 0 1
1 0 1 1 1 1 1 1 1 0 0 0 0 0 0 0 1 0 0 1 1 1 0 0 1
1 0 1 1 1 0 0 i 1 u 0 0 0 0 0 u 1 0 1 0 0 0 1 f 1
1 0 0 0 5 0 0 x 1 x u 0 0 0 u x 1 0 0 0 1 0 t 1 1
1 1 1 1 1 1 1 1 1 1 1 1 8 1 1 1 1 1 1 1 1 1 1 1 1
1 t 0 u 0 0 0 g 1 x 0 0 0 0 0 x 1 0 0 0 1 0 1 h 1
1 x 0 0 0 0 0 g 1 0 0 0 0 0 0 0 1 0 1 0 0 0 1 0 1
1 1 0 0 1 1 1 1 1 0 0 0 0 0 0 0 1 0 0 0 1 0 1 0 1
1 j 0 0 0 b 0 0 8 0 0 0 0 0 0 0 8 0 1 0 0 0 0 0 1
1 1 0 0 1 1 1 1 1 0 0 0 0 0 0 0 1 0 0 0 1 0 1 1 1
1 x 0 0 0 0 0 C 1 0 0 0 0 0 0 0 1 0 1 0 1 0 1 0 1
1 t 0 u 0 0 0 C 1 x 0 0 X 0 0 x 1 0 1 0 0 0 0 0 1
1 1 1 1 1 1 1 1 1 1 1 1 8 1 1 1 1 1 1 1 1 1 1 1 1
1 x 0 0 0 0 0 0 1 u 0 1 0 0 1 g 0 1 0 1 0 0 0 D 1
1 x 0 0 0 0 0 0 1 u 0 u 1 0 0 1 0 0 0 0 0 0 0 0 1
1 0 0 0 0 0 0 0 1 0 0 u u 1 0 1 1 1 1 1 0 0 0 0 1
1 0 G 0 0 0 0 0 6 0 0 0 0 1 0 0 0 k 0 0 0 0 0 0 1
1 0 0 0 0 0 0 0 1 0 0 0 0 g 1 1 1 1 0 0 0 0 0 0 1
1 x 0 0 0 0 0 0 1 u 0 u 0 1 1 0 0 0 0 0 0 0 0 0 1
1 x 0 0 0 0 0 0 b 0 0 1 0 6 0 0 1 1 0 0 0 0 0 D 1
1 1 1 1 1 1 1 1 1 1 1 1 1 1 1 1 1 1 1 1 1 1 1 1 1
