1 1 1 1 1 1 1 1 1 1 1 1 1 1 1 1 1 1 1 1 1 1 1 1
1 0 0 0 0 0 1 k 0 0 0 0 0 0 0 j 1 0 0 0 0 0 k 1
1 0 0 0 0 0 1 0 0 0 q O p 0 0 0 b 0 0 0 0 0 0 1
1 0 0 0 0 0 a 0 0 H 0 0 0 0 0 0 c 0 0 0 0 0 0 1
1 0 0 0 0 0 1 0 0 0 0 X 0 0 0 0 d 0 0 e 0 0 k 1
1 0 0 0 0 0 1 0 0 0 0 0 0 0 0 k 1 0 0 0 0 0 0 1
1 0 0 0 0 0 1 1 5 1 1 7 1 1 1 1 1 0 0 0 0 0 0 1
1 0 0 0 0 0 0 0 0 1 0 0 0 1 k e 1 0 k 0 0 0 0 1
1 0 0 0 0 0 0 0 0 1 e 0 0 1 0 0 1 0 0 0 0 0 0 1
1 0 0 0 0 0 0 0 0 1 0 0 0 1 0 0 0 0 0 0 0 0 0 1
1 1 1 1 1 1 1 1 1 1 0 0 0 1 1 1 1 1 1 1 b 1 1 1
1 k 0 0 1 0 0 0 0 1 1 6 1 1 e 0 v 1 0 0 0 0 0 1
1 0 0 0 1 0 f f e 0 0 0 0 0 0 0 0 6 0 0 d 0 0 1
1 0 0 0 7 0 e f e 0 0 0 0 0 0 0 0 1 0 0 0 0 0 1
1 0 0 0 1 j 0 0 0 0 0 0 0 0 0 0 0 1 0 0 0 0 0 1
1 0 0 0 1 1 1 1 1 1 1 1 1 1 1 1 1 1 1 1 1 7 1 1
1 0 0 0 1 1 1 0 0 0 0 0 0 0 0 0 0 e 0 1 e 0 0 1
1 0 0 0 0 6 0 0 0 0 k 0 0 0 0 0 0 0 0 1 0 0 0 1
1 1 7 1 1 1 1 0 0 0 0 0 0 f 0 0 0 0 0 1 0 0 0 1
1 0 0 0 0 0 1 0 0 0 0 0 0 0 0 0 0 0 0 1 0 0 0 1
1 0 0 0 0 0 1 1 1 1 1 1 1 1 1 1 1 1 1 1 0 0 0 1
1 0 0 g 0 0 1 k k k k k k k k k k k k k k 0 0 1
1 0 0 0 0 0 7 0 0 0 0 0 0 0 0 0 0 0 0 0 0 0 0 1
1 k 0 0 k 0 1 k k k k k k k k k k k k k 0 0 k 1
1 1 1 1 1 1 1 1 1 1 1 1 1 1 1 1 1 1 1 1 1 1 1 1
