1 1 1 1 1 1 1 1 1 1 1 1 1 1 1 1 1 1 1 1 1 1 1 1
1 0 0 0 0 0 1 l 0 0 0 0 0 0 0 k 1 0 0 0 0 0 k 1
1 0 0 0 0 0 1 0 0 0 h j i 0 0 0 1 0 0 0 0 0 0 1
1 0 0 0 0 0 5 0 0 0 0 0 0 0 0 0 4 0 0 0 0 0 0 1
1 0 0 0 0 0 1 0 0 m 0 0 0 0 0 0 1 0 0 a 0 0 l 1
1 0 0 0 0 0 1 0 0 0 0 0 0 0 0 l 1 0 0 0 0 0 0 1
1 0 0 0 0 0 1 1 1 1 1 5 1 1 1 1 1 0 0 0 0 0 0 1
1 0 0 0 0 0 0 0 0 1 0 0 0 1 k a 1 0 l 0 0 0 0 1
1 0 0 0 0 0 0 0 0 1 a 0 0 1 0 0 1 0 0 0 0 0 0 1
1 0 0 0 0 0 0 0 0 1 0 0 0 1 0 0 0 0 0 0 0 0 0 1
1 1 1 1 1 1 1 1 1 1 0 0 0 1 1 1 1 1 1 1 4 1 1 1
1 l 0 0 1 0 0 0 0 1 1 5 1 1 a 0 l 1 0 0 0 0 0 1
1 0 0 0 1 0 0 0 0 0 0 g 0 0 0 0 0 5 0 0 d 0 0 1
1 0 0 0 7 0 0 0 0 0 0 0 0 0 0 0 0 1 0 0 0 0 0 1
1 0 0 0 1 k 0 0 0 0 0 X 0 0 0 0 0 1 0 0 0 0 0 1
1 0 0 0 1 1 1 1 1 1 1 1 1 1 1 1 1 1 1 1 1 7 1 1
1 0 0 0 1 1 1 0 0 0 0 0 0 0 0 0 0 a 0 1 a 0 0 1
1 0 0 0 0 5 0 0 0 0 l 0 0 0 0 0 0 0 0 1 0 0 0 1
1 1 7 1 1 1 1 0 0 0 0 0 0 f 0 0 0 0 0 1 0 0 0 1
1 0 0 0 0 0 1 0 0 0 0 0 0 0 0 0 0 0 0 1 0 0 0 1
1 0 0 0 0 0 1 1 1 1 1 1 1 1 1 1 1 1 1 1 0 0 0 1
1 0 0 g 0 0 1 l l l l l l l l l l l l l l 0 0 1
1 0 0 0 0 0 7 0 0 0 0 0 0 0 0 0 0 0 0 0 0 0 0 1
1 k 0 0 l 0 1 l l l l l l l l l l l l l 0 0 k 1
1 1 1 1 1 1 1 1 1 1 1 1 1 1 1 1 1 1 1 1 1 1 1 1
