3 3 3 3 3 3 3 3 3 3 3 3 3 3 3 3 3 3 3 3 3 3 3 3 3 3 3 3 3 3 3 3 3 3 3 3 3 3
3 B B G B B 3 I 0 0 0 0 3 0 0 0 0 0 0 0 0 0 3 0 0 0 0 0 0 0 0 0 0 0 0 0 0 3
3 0 0 0 0 0 3 3 3 3 3 d 3 0 3 3 0 3 3 3 3 3 3 0 0 0 0 0 0 0 0 0 0 0 0 0 0 3
3 B E 0 E B 3 t 0 L 0 0 3 0 0 3 0 3 3 0 0 0 3 0 0 0 0 0 0 0 0 0 0 0 0 0 0 3
3 0 0 0 0 0 3 0 0 0 0 0 6 0 3 0 3 0 3 0 3 0 3 0 0 0 0 0 0 0 0 0 0 0 0 0 0 3
3 B 0 0 0 B 3 0 0 0 0 0 3 0 0 0 0 0 3 0 3 0 3 0 0 0 0 0 0 0 0 0 0 0 0 0 0 3
3 3 3 a 3 3 3 0 0 0 0 0 3 0 3 0 0 0 3 0 3 0 3 0 0 0 0 0 0 0 0 0 0 0 0 0 0 3
3 3 3 0 3 3 3 B 0 0 0 t 3 0 3 0 0 0 3 0 3 0 3 0 0 0 0 0 0 0 0 0 0 0 0 0 0 3
3 3 3 0 3 3 3 3 3 6 3 3 3 0 0 3 0 0 0 0 3 0 3 0 0 0 0 0 0 0 0 0 0 0 0 0 0 3
3 3 3 0 3 3 3 w E 0 E w 3 3 3 0 0 3 3 3 3 0 3 0 0 0 0 0 0 0 0 0 0 0 0 0 0 3
3 3 3 a 3 3 3 0 0 0 0 0 3 0 0 0 3 0 0 0 0 0 3 0 0 0 0 0 0 0 0 0 0 0 0 0 0 3
3 3 3 0 3 3 3 0 0 0 0 0 3 0 3 3 3 0 3 3 3 3 3 0 0 0 0 0 0 0 0 0 0 0 0 0 0 3
3 3 3 0 3 3 3 0 w M w 0 3 0 3 0 0 0 0 0 0 0 3 0 0 0 0 0 0 0 0 0 0 0 0 0 0 3
3 3 3 0 3 3 3 0 0 0 0 0 3 0 3 3 3 3 0 3 3 0 3 0 0 0 0 0 0 0 0 0 0 0 0 0 0 3
3 3 3 a 3 3 3 0 0 0 0 0 3 0 0 0 0 3 0 3 0 0 3 0 0 0 0 0 0 0 0 0 0 0 0 0 0 3
3 3 3 0 3 3 3 0 0 0 0 0 3 3 3 3 0 3 0 0 3 0 3 0 0 0 0 0 0 0 0 0 0 0 0 0 0 3
3 3 3 0 3 3 3 0 0 0 0 0 3 0 0 0 0 3 0 0 0 0 3 0 0 0 0 0 0 0 0 0 0 0 0 0 0 3
3 3 3 0 3 3 3 0 0 0 0 0 3 0 3 3 3 3 0 0 3 0 3 0 0 0 0 0 0 0 0 0 0 0 0 0 0 3
3 3 3 a 3 3 3 0 0 0 0 0 3 0 3 3 3 3 3 0 3 0 3 0 0 0 0 0 0 0 0 0 0 0 0 0 0 3
3 3 3 0 3 3 3 w E 0 E w 3 0 0 0 0 0 3 0 3 3 3 3 3 3 3 3 3 3 3 3 3 0 0 0 0 3
3 3 3 h 3 3 3 3 3 6 3 3 3 3 3 3 3 0 3 0 0 0 3 w 0 w 0 w 0 w 0 w 3 0 0 0 0 3
3 3 3 0 3 3 3 0 0 0 3 h 3 0 0 0 3 3 3 3 3 0 3 0 L 0 0 M 0 0 N 0 3 0 0 0 0 3
3 3 3 a 3 3 3 0 3 0 3 0 3 3 3 0 0 0 0 0 0 0 3 0 0 0 0 0 0 0 0 0 3 0 0 0 0 3
3 3 3 0 3 3 3 0 3 0 3 d 3 0 0 0 3 3 0 3 3 3 3 0 0 0 0 0 0 0 0 0 3 0 0 0 0 3
3 3 3 0 3 3 3 0 3 0 3 0 3 0 3 3 3 3 0 0 0 0 3 E 0 0 0 0 0 0 0 E 3 0 0 0 0 3
3 3 3 0 3 3 3 0 3 0 3 e 3 0 3 3 3 3 3 3 0 3 3 3 3 3 3 0 3 3 3 3 3 3 3 3 3 3
3 3 3 a 3 3 3 0 3 0 3 0 3 0 0 0 3 0 0 0 0 0 3 3 3 3 3 6 3 4 4 4 4 4 4 4 4 4
3 B B 0 B B 3 0 3 0 3 0 3 3 3 0 3 0 3 3 3 0 3 t 0 0 D 0 3 4 0 0 0 0 0 E 0 4
3 E 0 0 0 E 3 0 3 0 3 0 3 0 3 0 3 0 0 0 0 3 3 E 0 0 0 0 3 4 0 0 0 l 0 B 0 4
3 0 0 0 0 0 6 0 3 0 3 0 3 0 3 0 3 3 0 3 3 0 6 0 0 0 0 0 3 4 0 0 0 e 0 0 F 4
3 E 0 0 0 E 3 0 3 0 3 0 3 0 3 0 3 0 0 0 0 0 3 E 0 0 0 0 6 0 0 0 0 r 0 H 0 4
3 B B X B B 3 e 3 0 0 0 3 0 0 0 3 0 3 0 3 i 3 t 0 0 D 0 3 4 0 0 0 h 0 0 0 4
3 3 3 6 3 3 3 3 3 3 3 3 3 3 3 3 3 3 3 3 3 3 3 3 3 3 3 6 3 4 0 0 0 p 0 B 0 4
3 C 0 0 6 0 0 a 0 h 0 h 0 a 0 0 a 0 0 a 0 0 a 0 0 a 0 0 3 4 0 0 0 0 0 E 0 4
3 3 3 3 3 3 3 3 3 3 3 3 3 3 3 3 3 3 3 3 3 3 3 3 3 3 3 3 3 4 4 4 4 4 4 4 4 4
