3 3 3 3 3 3 3 3 3 3 3 3 3
3 B B G B B 3 I 0 0 0 0 3
3 0 0 0 0 0 3 3 3 3 3 d 3
3 B E 0 E B 3 0 0 0 0 0 3
3 0 0 0 0 0 3 0 0 0 0 0 3
3 B 0 0 0 B 3 0 0 0 0 0 3
3 3 3 a 3 3 3 0 0 0 0 0 3
3 3 3 0 3 3 3 0 0 0 0 0 3
3 3 3 0 3 3 3 3 3 6 3 3 3
3 3 3 0 3 3 3 0 0 0 0 0 3
3 3 3 a 3 3 3 0 0 0 0 0 3
3 3 3 0 3 3 3 0 0 0 0 0 3
3 3 3 0 3 3 3 0 0 0 0 0 3
3 3 3 0 3 3 3 0 0 0 0 0 3
3 3 3 a 3 3 3 0 0 0 0 0 3
3 3 3 0 3 3 3 0 0 0 0 0 3
3 3 3 0 3 3 3 0 0 0 0 0 3
3 3 3 0 3 3 3 0 0 0 0 0 3
3 3 3 a 3 3 3 0 0 0 0 0 3
3 3 3 0 3 3 3 0 0 0 0 0 3
3 3 3 h 3 3 3 3 3 6 3 3 3
3 3 3 0 3 3 3 0 0 0 0 0 3
3 3 3 a 3 3 3 0 0 0 0 0 3
3 3 3 0 3 3 3 0 0 0 0 0 3
3 3 3 0 3 3 3 0 0 0 0 0 3
3 3 3 0 3 3 3 0 0 0 0 0 3
3 3 3 a 3 3 3 0 0 0 0 0 3
3 B B 0 B B 3 0 0 0 0 0 3
3 E 0 0 0 E 3 0 0 0 0 0 3
3 0 0 0 0 0 6 0 0 0 0 0 3
3 E 0 0 0 E 3 0 0 0 0 0 3
3 B B X B B 3 0 0 0 0 0 3
3 3 3 3 3 3 3 3 3 3 3 3 3
