2 2 2 2 2 2 2 2 2 2 2 2 2 2 2 2 2 2 2 2 2 2 2 2 2 2 2 2 2 2 2 2 2 2 2 2 2 2 2 2 2
2 0 0 0 0 0 0 0 0 2 2 0 0 0 t 2 0 0 0 0 c 0 0 0 0 0 0 0 0 J 2 2 2 2 2 2 2 2 2 2 2
2 0 2 2 0 2 0 2 0 0 8 0 2 0 2 2 0 2 2 2 2 2 2 2 2 2 2 2 2 2 2 2 2 2 2 2 2 2 2 2 2
2 0 2 2 0 2 0 2 0 2 2 2 2 0 0 2 0 2 0 0 2 y g e g e g e g y 2 2 2 2 2 2 2 2 2 2 2
2 0 0 2 0 0 0 0 0 0 2 0 2 2 0 2 0 0 2 0 2 0 0 0 0 0 0 0 0 0 2 2 2 0 0 0 0 0 2 2 2
2 2 0 2 0 0 2 0 2 0 2 0 0 0 0 0 2 0 2 0 2 0 0 0 0 0 0 0 0 0 2 2 2 0 0 0 0 0 2 2 2
2 2 0 2 0 0 2 0 2 0 2 0 2 0 2 0 2 0 2 0 2 0 0 0 0 0 0 0 0 0 2 2 2 0 0 0 0 0 2 2 2
2 z h A 2 0 2 0 2 0 2 0 2 0 2 0 2 0 0 0 2 M 0 0 0 0 0 0 0 L 2 2 2 0 0 0 0 0 2 2 2
2 e 0 e 2 0 2 0 2 0 2 0 0 0 0 0 0 0 2 2 2 0 0 0 0 0 0 0 0 0 2 2 2 2 2 2 2 2 2 2 2
2 A h z 2 0 0 0 0 0 2 k 2 t 2 0 2 0 0 0 2 0 0 0 y 0 y 0 0 0 2 2 2 2 2 2 2 2 2 2 2
2 2 2 2 2 2 2 2 2 2 2 2 2 2 2 8 2 2 2 2 2 2 2 2 2 6 2 2 2 2 2 2 2 2 2 2 2 2 2 2 2
2 e 2 0 a 0 0 0 a 0 2 u 0 y 0 0 0 y 0 u 2 u 0 0 E 0 E 0 0 u 2 4 4 4 4 4 4 4 4 4 4
2 0 2 0 2 2 0 2 2 0 2 0 0 0 0 0 0 0 0 0 2 0 0 0 0 0 0 0 0 0 2 4 u 0 0 0 0 0 E 0 4
2 0 2 f j 2 a 2 h f 2 0 0 0 0 0 0 0 0 0 2 0 0 0 0 0 0 0 0 C 2 4 0 0 0 0 m 0 E 0 4
2 0 2 2 2 2 0 2 2 2 2 E 0 0 0 0 0 0 0 E 2 0 0 0 0 0 0 0 0 C 2 4 0 0 0 0 o 0 0 F 4
2 0 0 0 a 0 0 a 0 0 8 0 0 0 0 0 0 0 0 0 8 0 0 0 0 0 0 0 0 0 6 0 0 0 0 0 Q 0 H 0 4
2 0 2 2 2 2 0 2 2 2 2 E 0 0 0 0 0 0 0 E 2 0 0 0 0 0 0 0 0 C 2 4 0 0 0 0 P 0 0 0 4
2 0 2 g g 2 a 2 g g 2 0 0 0 0 0 0 0 0 0 2 0 0 0 0 0 0 0 0 C 2 4 0 0 0 0 s 0 E 0 4
2 0 2 g 2 2 0 2 2 g 2 0 0 0 0 0 0 0 0 0 2 0 0 0 0 0 0 0 0 0 2 4 u 0 0 0 0 0 E 0 4
2 i 2 0 a 0 e 0 a 0 2 u 0 y 0 X 0 y 0 u 2 z A z A 0 A z A z 2 4 4 4 4 4 4 4 4 4 4
2 2 2 2 2 2 2 2 2 2 2 2 2 2 2 7 2 2 2 2 2 2 2 2 2 8 2 2 2 2 2 2 2 2 2 2 2 2 2 2 2
2 C G C 2 2 2 2 0 0 2 u 0 0 0 0 0 0 0 u 2 0 0 f E 0 E D 0 0 2 0 e K e 0 A 2 2 2 2
2 0 0 0 2 2 0 a 0 0 2 0 g g g g g g g 0 2 0 0 0 E 0 E 0 0 0 2 0 0 0 0 0 h 2 2 2 2
2 0 0 0 2 2 0 2 0 0 2 0 g g g g g g g 0 2 0 0 0 E 0 E 0 0 0 2 0 0 0 0 0 A 2 2 2 2
2 0 0 0 2 2 a 2 0 0 2 u g g g g g g g u 2 0 E E E 0 E E E 0 2 0 0 0 0 0 g 2 2 2 2
2 0 0 0 2 2 0 2 u 0 2 2 2 2 2 2 2 2 2 2 2 0 0 0 0 0 0 0 0 0 5 0 0 0 0 0 A 2 2 2 2
2 2 a 2 2 2 a 2 e 0 2 0 0 0 0 0 0 0 0 0 8 0 E E E 0 E E E 0 2 2 2 2 2 2 2 2 2 2 2
2 2 0 2 2 C 0 2 2 2 2 a 2 2 2 2 2 2 2 0 2 0 0 0 E 0 E 0 0 0 2 2 2 2 2 2 2 2 2 2 2
2 2 a 0 a 0 0 0 a 0 5 0 0 0 0 0 0 0 0 0 2 0 0 0 E 0 E 0 0 0 2 2 2 2 2 2 2 2 2 2 2
2 2 2 2 2 2 2 2 2 2 2 0 2 u 2 f 2 0 2 0 2 0 0 u E 0 E y 0 0 2 2 2 2 2 2 2 2 2 2 2
2 2 2 2 2 2 2 2 2 2 2 2 2 2 2 2 2 2 2 2 2 2 2 2 2 2 2 2 2 2 2 2 2 2 2 2 2 2 2 2 2
