1 1 1 1 1 1 1 1 1 1 1 1 1 1 1 1 1 1 1 1 1 1 1 1 1 1 1 1 1 1 1 1 1 1 1 1 1 1 1 1 1
1 t 0 0 0 0 0 0 1 1 1 1 1 1 0 u z u z u z u z u z u z 0 0 0 0 E 1 0 0 0 C 1 1 1 1
1 0 1 1 1 1 1 0 1 0 0 0 0 a 0 0 0 0 0 0 0 0 0 0 0 0 0 0 0 0 0 0 5 0 0 0 C 1 1 1 1
1 0 0 0 0 0 1 0 0 0 1 1 1 1 0 0 0 0 0 0 0 0 0 0 0 0 0 0 0 0 0 E 1 0 0 0 C 1 1 1 1
1 1 1 1 1 0 1 1 1 1 1 1 1 1 0 u z u z u z u z u z u z 0 0 0 0 u 1 0 0 0 g 1 1 1 1
1 0 0 0 1 0 1 1 1 1 1 1 1 1 0 1 1 1 1 1 1 1 1 1 1 1 1 1 1 1 1 1 1 D 0 0 0 1 1 1 1
1 1 1 1 1 6 1 1 1 1 1 1 1 1 0 1 1 1 1 1 1 1 1 1 1 1 1 1 1 1 1 1 1 1 8 1 1 1 1 1 1
1 x 0 0 0 0 0 0 0 x 1 1 1 1 t 0 0 0 0 f e 0 0 b 0 0 0 0 0 0 0 j 1 x 0 0 x 1 1 1 1
1 0 0 0 0 0 0 0 0 0 1 1 1 1 1 1 1 1 1 1 1 1 1 1 1 1 1 1 1 1 1 1 1 x g g x 1 1 1 1
1 0 0 0 0 0 0 0 0 0 1 u u 0 0 0 0 0 0 C C C C 0 0 C C C C 0 0 0 1 0 g g 0 b 0 k 1
1 0 0 0 0 0 0 0 0 0 1 u u 0 0 0 0 0 0 0 0 0 0 0 0 0 0 0 0 0 0 0 1 x 0 0 x 1 1 1 1
1 0 0 0 0 0 0 0 0 0 1 u x 0 0 0 0 0 0 0 0 0 0 0 0 0 0 0 0 0 0 0 1 x 0 0 x 1 0 h 1
1 0 0 0 0 0 0 0 0 0 1 t h 0 0 0 0 0 0 0 0 0 0 0 0 0 0 0 0 0 0 0 1 0 0 0 0 1 1 0 1
1 0 0 0 0 0 0 0 0 0 1 u x 0 0 0 0 0 0 0 0 0 0 0 0 0 0 0 0 0 0 0 1 0 0 0 0 1 0 0 1
1 0 0 0 0 0 0 0 0 0 1 u u 0 0 0 0 0 0 C C C C 0 0 C C C C 0 0 0 1 0 0 0 0 1 0 1 1
1 0 0 0 0 0 0 0 0 0 1 1 1 1 1 1 1 1 1 1 1 1 1 1 1 1 1 1 1 1 1 0 1 E 0 0 E 1 0 1 1
1 0 0 0 0 X 0 0 0 0 0 0 0 0 0 0 0 0 0 0 0 0 0 0 0 0 0 0 0 0 0 0 1 E 0 0 E 1 0 1 1
1 1 1 1 1 1 1 1 1 1 1 1 1 1 1 1 1 1 1 1 1 1 1 1 1 1 1 1 1 1 1 1 1 E 0 0 E 1 0 1 1
1 0 0 1 0 G 0 1 0 0 0 1 0 0 0 0 4 4 4 4 4 4 4 4 4 4 4 1 E 0 0 0 0 0 0 0 0 1 0 0 1
1 0 0 1 0 0 0 1 0 0 0 1 0 0 0 0 4 0 0 F 0 0 0 0 0 0 4 1 0 0 0 0 0 0 0 0 0 1 1 0 1
1 0 0 1 0 0 0 1 0 0 0 1 0 0 0 0 4 0 E 0 0 H 0 0 E 0 4 1 0 0 0 0 0 0 0 0 0 1 0 0 1
1 1 1 1 1 6 1 1 1 1 1 1 0 0 0 0 4 0 0 0 0 0 0 0 0 0 4 1 x 0 0 0 0 0 0 0 0 0 0 1 1
1 x 0 0 0 0 0 0 0 x 1 1 0 0 0 0 4 0 0 h r q e n 0 0 0 6 0 0 0 0 0 0 0 0 0 1 1 1 1
1 0 0 x 0 0 0 0 0 x 1 1 0 0 0 0 4 0 0 0 0 0 0 0 0 0 4 1 x 0 0 0 0 0 0 0 0 1 1 1 1
1 0 1 b 1 8 1 t 0 0 g 1 0 0 0 0 4 0 0 0 0 0 0 0 0 0 4 1 0 0 0 0 0 0 0 0 0 1 1 1 1
1 0 1 0 1 0 1 1 1 1 1 1 0 0 0 0 4 0 0 0 0 0 0 0 0 0 4 1 0 0 0 0 0 0 0 0 0 1 1 1 1
1 g 1 h 1 0 0 g 0 0 0 1 0 0 0 0 4 4 4 4 4 4 4 4 4 4 4 1 E 0 C C 0 C C 0 E 1 1 1 1
1 1 1 1 1 1 1 1 1 1 0 1 1 1 1 1 1 1 1 1 1 1 1 1 1 1 1 1 1 1 1 1 8 1 1 1 1 1 1 1 1
1 1 0 0 0 0 0 0 i 1 0 0 0 0 C C C C C C 1 0 0 0 0 0 0 1 x u 0 0 0 0 0 u x 1 1 1 1
1 1 0 1 1 1 1 1 1 1 1 1 0 0 0 0 0 0 0 0 1 0 g g g g 0 1 u 0 0 0 0 0 0 0 u 1 1 1 1
1 1 0 1 0 0 0 0 0 1 1 1 0 0 0 0 0 0 0 0 1 0 g g g g 0 7 0 0 0 0 0 0 0 0 0 1 1 1 1
1 1 0 1 0 1 1 1 0 1 1 1 0 0 0 C 0 0 0 0 1 0 g g g g 0 1 0 0 0 0 0 0 0 0 0 1 1 1 1
1 1 0 1 0 0 0 1 0 0 1 1 0 0 0 0 0 0 0 0 1 0 0 0 0 0 0 1 0 0 0 0 0 0 0 0 0 1 1 1 1
1 1 0 1 1 1 0 1 1 0 0 b 0 0 0 C 0 0 0 0 1 1 1 1 1 1 1 1 0 0 0 0 0 0 0 0 u 1 1 1 1
1 1 0 0 0 1 1 1 0 0 1 1 0 0 0 0 0 0 0 0 0 0 0 0 0 0 0 0 0 0 0 0 0 0 0 u x 1 1 1 1
1 1 1 1 0 1 1 1 0 1 1 1 C 0 0 0 0 0 0 E 1 1 1 1 1 1 1 1 1 1 1 1 1 1 1 1 1 1 1 1 1
1 1 1 1 0 0 0 0 0 1 1 1 1 1 1 1 1 1 1 1 1 1 1 1 1 1 1 1 1 1 1 1 1 1 1 1 1 1 1 1 1
1 1 1 1 1 1 1 1 1 1 1 1 1 1 1 1 1 1 1 1 1 1 1 1 1 1 1 1 1 1 1 1 1 1 1 1 1 1 1 1 1
