1 1 1 1 1 1 1 1 1 1 1 1 1 1 1 1 1 1 1 1 1 1 1 1
1 0 0 0 0 0 0 0 0 0 0 0 0 0 0 0 1 0 0 0 0 0 0 1
1 0 0 9 0 0 0 0 0 0 8 0 0 0 0 0 0 0 0 0 0 0 0 1
1 0 0 0 0 0 0 0 0 0 0 0 0 0 0 0 0 0 0 0 0 0 0 1
1 0 3 0 0 0 0 0 0 0 0 0 0 0 0 0 1 0 0 0 0 0 0 1
1 0 1 0 0 0 0 1 1 1 0 1 1 1 1 1 1 1 0 1 1 1 1 1
1 0 1 0 0 0 0 1 0 1 0 1 0 1 0 1 1 0 0 0 1 1 1 1
1 0 2 0 0 0 0 1 0 6 6 6 6 6 0 1 1 0 0 0 0 0 0 3
1 0 1 0 0 0 0 0 0 6 7 7 6 6 0 0 0 0 0 0 1 1 1 1
1 0 3 0 0 0 0 1 0 6 6 6 6 6 0 1 1 0 0 0 0 0 0 3
1 0 0 0 0 0 0 1 0 0 0 0 0 0 0 1 1 0 0 0 1 1 1 1
1 0 0 0 0 0 0 1 1 1 1 0 1 1 1 1 1 1 1 1 1 1 1 1
2 2 2 2 2 2 2 2 2 2 2 0 2 2 2 2 2 2 2 2 2 2 2 2
3 0 0 0 0 0 0 0 0 0 0 0 0 0 0 0 0 0 0 0 0 0 0 1
2 2 2 2 2 2 0 2 2 2 2 0 2 2 2 2 2 2 2 2 2 2 2 2
1 1 1 1 1 1 0 1 1 1 2 0 2 2 2 2 2 2 2 2 3 3 3 3
1 0 0 0 0 0 0 0 0 1 2 0 2 2 0 0 0 0 0 2 0 0 0 2
1 0 0 0 0 0 0 0 0 0 0 0 2 2 0 0 1 0 0 2 0 0 0 2
1 0 0 0 0 0 0 0 0 1 2 0 2 2 0 0 0 0 0 2 2 0 2 2
1 0 2 0 2 0 0 0 0 1 2 0 0 0 0 0 1 0 0 0 0 0 0 2
1 0 0 1 0 0 0 0 0 1 2 0 2 2 0 0 0 0 0 2 2 0 2 2
1 0 2 0 2 0 0 0 0 1 2 0 2 2 0 0 1 0 0 2 0 0 0 2
1 0 0 0 0 0 0 0 0 1 2 0 2 2 0 0 0 0 0 2 0 0 0 2
1 1 1 1 1 1 1 1 1 1 1 1 1 2 2 2 2 2 2 3 3 3 3 3
