1 1 1 1 1 1
1 e e f 0 1
1 0 0 0 0 1
1 0 X 0 0 1
1 1 1 1 1 1
